WWWWWWWWWWWWWWWWWWWWWWWWWWWWWWWWWWWWWWWWWWWWWWWWWW
WFFFFFFFFFFFFFFFWFFFFFFFFFFFFFFFFFFFFFFFFWFFFFFFFW
WFFFFFFFFFFFFFFFWFFFFFFFFFFFFFFFFFFFFFFFFWFFFFFFFW
WFFFFFFFFFFFFFFFWFFFFFFFFFFFFFFFFFFFFFFFFWFFFFFFFW
WFFFFFFFFFFFFFFFWFFFFFFFFFFFFFFFFFFFFFFFFWFFFFFFFW
WFFFFFFFFFFFFFFFWFFFFFFFFFFFFFFFFFFFFFFFFWFFFFFFFW
WWWWWWWWFFFFWWWWWFFFFFFFWWWWWWWFFFFFFWWWWWFFFFFFFW
WFFFFFFFFFFFFWFFFFFFFFFFWWFFFFFFFFFFFFWFFFFFFFFFFW
WFFFFFFFFFFFFWFFFFFFFFFFWWFFFFFFFFFFFFWFFFFFFFFFFW
WFFFFFFFFFFFFWFFFFFFFFFFWWFFFFFFFFFFFFWFFFFFFFFFFW
WFFFFWFFFFFFFWFFFFFFFFFFWWFFFFFFFFFFFFWFFFFFFFFFFW
WFFFFWFFFFFFFWWWWWWFFFFFWWFFFFFFFFFFFFFFFFFFFFFFFW
WFFFFWFFFFFFFFFFFFFFFFFFWWFFFFFFFFFFFFFFFFFFFFFFFW
WFFFFWFFFFFFFFFFFFFFFFFFWWFFFFFFFFFFFFFFFFFFFFFFFW
WFFFFWFFFFFFFFFFFFFFFFFFWWFFFFFFFFFFFFFFFFFFFFFFFW
WFFFFFFFFFFFFFFFFFFWWWWWWWFFFFFFFFFFFFWFFFFFFFFFFW
WFFFFFFFFFFFFFFFFFFFFFFFWWFFFFFFFFFFFFWFFFFFFFFFFW
WFFFFFFFFFFFFFFFFFFFFFFFWWFFFFFFFFFFFFWFFFFFFFFFFW
WWWWWWWWWWWWWWWWWWWWWWWWWWWWWWWWWWWWWWWWWWWWWWWWWW