WWWWWWWWWWWWWWWWWWWWWWWWWWWWWWWWWWWWWWWWWWWWWWWWWW
WFFFFFFFFFFFFFFFFFFFFFFFFFFFFFFFFFFFFFFFFWFFFFFFFW
WFFFFFFFFFFFFFFFFFFFFFFFFFFFFFFFFFFFFFFFFWFFFFFFFW
WFFFWFFFFFFFFFFFFFFFFFFFFFFFFFFFFFFFFFFFFWFFFFFFFW
WFFFWFFFFFFFFFFFFFFFFFFFFFFFFFFFFFFFFFFFFWFFFFFFFW
WFFFWFFFWWWWWWWWWWFFFFFFFFFFFFFFFFFFFFFFFWFFFFFFFW
WFFFWFFFWFFFFFFFFWFFFFFFFWWWWWWFFFFFFWWWWWFFFFFFFW
WFFFWFFFWFFFFFFFFWFFFWWWWWFFFFFFFFFFFFWFFFFFFFFFFW
WFFFWFFFWFFFFFFFFWFFFFFFFWFFFFFFFFFFFFWFFFFFFFFFFW
WFFFWFFFWFFFFFFFFWFFFFFFFWFFFFFFFFFFFFWFFFFFFFFFFW
WFFFWFFFWFFFFFFFFWFFFFFFFWFFFFFFFFFFFFWFFFFFFFFFFW
WFFFFFFFWFFFFFFFFFFFFFFFFWFFFFFFFFFFFFFFFFFFFFFFFW
WFFFFFFFWFFFFFFFFFFFFFFFFWFFFFFFFFFFFFFFFFFFFFFFFW
WFFFFFFFWFFFFFFFFFFFFFFFFWFFFFFFFFFFFFFFFFFFFFFFFW
WFFFFFFFWFFFFFFFFFFFFFFFFWFFFFFFFFFFFFFFFFFFFFFFFW
WFFFFFFFWWWWWWWWWWFFFFFFFWFFFFFFFFFFFFWFFFFFFFFFFW
WFFFFFFFFFFFFFFFFFFFFFFFFWFFFFFFFFFFFFWFFFFFFFFFFW
WFFFFFFFFFFFFFFFFFFFFFFFFWFFFFFFFFFFFFWFFFFFFFFFFW
WWWWWWWWWWWWWWWWWWWWWWWWWWWWWWWWWWWWWWWWWWWWWWWWWW
